# Map Name
Sieged under plague
# Map Dimensions W x H
64 64
# Map Terrain Data
RRRRRRRRdgGggdRRRRRRRRRRRRRRRRRRRRRRRRRRRRRRRRRRRRRRRRRRRRRRRRRRR
RRRRRRRddgGggdRRRRRRRRRRRRRRRRRRRRRRRRRRRRRRRRRRRRRRRRRRRRRRRRRRR
RRRRRRRdggGGgddRRRRRRRRRRRRRRRRRRRRRRRRRRRRRRRRRRRRRRRRRRRRRRRRRR
RRRRRRRdggGGggdRRRRRRRRRRRRRRRRRRRRRRRRRRRRRRRRRRRRRRRRRRRRRRRRRR
RRRRRRRddggGggdRRRRRRRRRRRRRRRRRRRRRRRRRRRRRRRRRRRRRRRRRRRRRRRRRR
RRRRRRRRdggGgddRRRRRRRRRRRRRRRRRRRRRRRRRRRRRRRRRRRRRRRRRRRRRRRRRR
RRRRRRRRdggggdRRRRRRRRRRRRRRRRRRRRRRRRRRRRRRRRRRRRRRRRRRRRRRRRRRR
RRRRRRRRddgggdRRRRRRRRRRRRRRRRRRRRRRRRRRRRRRRRRRRRRRRRRRRRRRRRRRR
RRRRRRRRRddgdddRRRRRRRRRRRRRRRRRRRRRRRRRRRRRRRRRRRRRRRRRRRRRRRRRR
RRRRRRRRRddddddddRRRRRRRRRRRRRRRRRRRRRRRRRRRRRRdddddddddRRRRRRRRR
RRRRRRRRRRddddddddddddRRRRRRRdddddddddddddddRRdddggddggddddRRRRRR
RRRRRRRRRRdggggggggdddddddddddddddgggggggggdddddggggggddggddRRRRR
RRRRRRRRRRdgGGGGgggggggggggggggggggggGGGGGGgggggGGGGGgdRdddRRRRRR
RRRRRRRRRRdgGGGGGGGGGGGGGGGGGGGGGGGGGGGGGGGGGGGGGGGGGgdRRdgddRRRR
RRRRRRRRRRdgGGGGGGGGGGGGGGGGGGGGGGGGGGGGGGGGGGGGGGGGGgdRRdgddRRRR
RRRRRRRRRRdgGGGGGGGGGGGGGGGGGGGGGGGGGGGGGGGGGGGGGGGGGgdRRRdggdddR
RRRRRRRRRRdgGGGGGGGGGGGGGGGGGGGGGGGGGGGGGGGGGGGGGGGGGgdRRRddgggdd
RRRRRRRRRRdgGGGGGGGGGGGGGGGGGGGGGGGGGGGGGGGGGGGGGGGGGgdRRRRdgdddd
RRRRRRRRRRdgGGGGGGGGGGGGGGGGGGGGGGGGGGGGGGGGGGGGGGGGGgdRRRRddddgg
RRRRRRRRRRdgGGGGGGGGGGGGGGGGGGGGGGGGGGGGGGGGGGGGGGGGGgdRRRRRRdddd
RRRRRRRRRRdgGGGGGGGGGGGGGGGGGGGGGGGGGGGGGGGGGGGGGGGGGgdRRRRRRRRdd
RRRRRRRRRRdgGGGGGGGGGGGGGGGGGGGGGGGGGGGGGGGGGGGGGGGGGgdRRRRRRRRRR
RRRRRRRRRRdgGGGGGGGGGGGGGGGGGGGGGGGGGGGGGGGGGGGGGGGGGgdRRRRRRRRRR
RRRRRRRRRRdgGGGGGGGGGGGGGGGGGGGGGGGGGGGGGGGGGGGGGGGGGgdRRRRRRRRRR
RRRRRRRRRRdgGGGGGGGGGGGGGGGGGGGGGGGGGGGGGGGGGGGGGGGGGgdRRRRRRRRRR
RRRRRRRRRRdgGGGGGGGGGGGGGGGGGGGGGGGGGGGGGGGGGGGGGGGGGgdRRRRRRRRRR
RRRRRRRRRRdgGGGGGGGGGGGGGGGGGGGGGGGGGGGGGGGGGGGGGGGGGgdRRRRRRRRRR
RRRRRRRRRRdgGGGGGGGGGGGGGGGGGGGGGGGGGGGGGGGGGGGGGGGGGgdRRRRRRRRRR
RRRRRRRRRRdgGGGGGGGGGGGGGGGGGGGGGGGGGGGGGGGGGGGGGGGGGgdRRRRRRRRRR
RRRRRRRRRRdgGGGGGGGGGGGGGGGGGGGGGGGGGGGGGGGGGGGGGGGGGgdRRRRRRRRRR
RRRRRRRRRRdgGGGGGGGGGGGGGGGGGGGGGGGGGGGGGGGGGGGGGGGGGgdRRRRRRRRRR
RRRRRRRRRRdgGGGGGGGGGGGGGGGGGGGGGGGGGGGGGGGGGGGGGGGGGgdRRRRRRRRRR
RRRRRRRRRRdgGGGGGGGGGGGGGGGGGGGGGGGGGGGGGGGGGGGGGGGGGgdRRRRRRRRRR
RRRRRRRRRRdgGGGGGGGGGGGGGGGGGGGGGGGGGGGGGGGGGGGGGGGGGgdRRRRRRRRRR
RRRRRRRRRRdgGGGGGGGGGGGGGGGGGGGGGGGGGGGGGGGGGGGGGGGGGgdRRRRRRRRRR
RRRRRRRRRRdgGGGGGGGGGGGGGGGGGGGGGGGGGGGGGGGGGGGGGGGGGgdRRRRRRRRRR
RRRRRRRRRRdgGGGGGGGGGGGGGGGGGGGGGGGGGGGGGGGGGGGGGGGGGgdRRRRRRRRRR
RRRRRRRRRRdgGGGGGGGGGGGGGGGGGGGGGGGGGGGGGGGGGGGGGGGGGgdRRRRRRRRRR
RRRRRRRRRRdgGGGGGGGGGGGGGGGGGGGGGGGGGGGGGGGGGGGGGGGGGgdRRRRRRRRRR
RRRRRRRRRRdgGGGGGGGGGGGGGGGGGGGGGGGGGGGGGGGGGGGGGGGGGgdRRRRRRRRRR
RRRRRRRRRRdgGGGGGGGGGGGGGGGGGGGGGGGGGGGGGGGGGGGGGGGGGgdRRRRRRRRRR
RRRRRRRRRRdgGGGGGGGGGGGGGGGGGGGGGGGGGGGGGGGGGGGGGGGGGgdRRRRRRRRRR
RRRRRRRRRRdgGGGGGGGGGGGGGGGGGGGGGGGGGGGGGGGGGGGGGGGGGgdRRRRRRRRRR
RRRRRRRRRRdgGGGGGGGGGGGGGGGGGGGGGGGGGGGGGGGGGGGGGGGGGgdRRRRRRRRRR
RRRRRRRRRRdgGGGGGGGGGGGGGGGGGGGGGGGGGGGGGGGGGGGGGGGGGgdRRRRRRRRRR
RRRRRRRRRRdgGGGGGGGGGGGGGGGGGGGGGGGGGGGGGGGGGGGGGGGGGgdRRRRRRRRRR
RRRRRRRRRRdgGGGGGGGGGGGGGGGGGGGGGGGGGGGGGGGGGGGGGGGGGgdRRRRRRRRRR
RRRRRRRRRRdgGGGGGGGGGGGGGGGGGGGGGGGGGGGGGGGGGGGGGGGGGgdRRRRRRRRRR
RRRRRRRRRRdgGGGGGGGGGGGGGGGGGGGGGGGGGGGGGGGGGGGGGGGGGgdRRRRRRRRRR
RRRRRRRRRRdgGGGGGGGGGGGGGGGGGGGGGGGGGGGGGGGGGGGGGGGGGgdRRRRRRRRRR
RRRRRRRRRRdgGGGGGGGGGGGGGGGGGGGGGGGGGGGGGGGGGGGGGGGGGgdRRRRRRRRRR
RRRRRRRRRRdgGGGGGGGGGGGGGGGGGGGGGGGGGGGGGGGGGGGGGGGGGgdRRRRRRRRRR
RRRRRRRRRddgGGGGGGGGGGGGGGGGGGGGGGGGGGGGGGGGGGGGGGGGGgddRRRRRRRRR
RRRRRRRRdddgggggggggggggggggggggggggggggggggggggggggggddRRRRRRRRR
RRRRRdddddddddddddddddddddddddddddddddddddddddddddddddddRRRRRRRRR
RRRRdddgddddRRRRRRRRRRRRRRRRRRRRRRRRRRRRRRRRRRRRRdddddddRRRRRRRRR
RRRRddgggddRRRRRRRRRRRRRRRRRRRRRRRRRRRRRRRRRRRRRRRdddggddRRRRRRdd
RRRRRdgggdRRRRRRRRRRRRRRRRRRRRRRRRRRRRRRRRRRRRRRRRRdggGgddRRddddd
RRRRRddgddRRRRRRRRRRRRRRRRRRRRRRRRRRRRRRRRRRRRRRRRRddggggddddgggd
RRRRdddddRRRRRRRRRRRRRRRRRRRRRRRRRRRRRRRRRRRRRRRRRRRdddddgggggGgg
RRdddgdddRRRRRRRRRRRRRRRRRRRRRRRRRRRRRRRRRRRRRRRRRRRRRRRddggggggg
dddggggdRRRRRRRRRRRRRRRRRRRRRRRRRRRRRRRRRRRRRRRRRRRRRRRRRddddddgg
gggggggddRRRRRRRRRRRRRRRRRRRRRRRRRRRRRRRRRRRRRRRRRRRRRRRRRRRRRddd
ggggggggdRRRRRRRRRRRRRRRRRRRRRRRRRRRRRRRRRRRRRRRRRRRRRRRRRRRRRRRR
ggggggggdRRRRRRRRRRRRRRRRRRRRRRRRRRRRRRRRRRRRRRRRRRRRRRRRRRRRRRRR
# Map Partial Bits
FFFFFFFFFFFFFFFFFFFFFFFFFFFFFFFFFFFFFFFFFFFFFFFFFFFFFFFFFFFFFFFFF
FFFFFFFFFFFFFFFFFFFFFFFFFFFFFFFFFFFFFFFFFFFFFFFFFFFFFFFFFFFFFFFFF
FFFFFFFFFFFFFFFFFFFFFFFFFFFFFFFFFFFFFFFFFFFFFFFFFFFFFFFFFFFFFFFFF
FFFFFFFFFFFFFFFFFFFFFFFFFFFFFFFFFFFFFFFFFFFFFFFFFFFFFFFFFFFFFFFFF
FFFFFFFFFFFFFFFFFFFFFFFFFFFFFFFFFFFFFFFFFFFFFFFFFFFFFFFFFFFFFFFFF
FFFFFFFFFFFFFFFFFFFFFFFFFFFFFFFFFFFFFFFFFFFFFFFFFFFFFFFFFFFFFFFFF
FFFFFFFFFFFFFFFFFFFFFFFFFFFFFFFFFFFFFFFFFFFFFFFFFFFFFFFFFFFFFFFFF
FFFFFFFFFFFFFFFFFFFFFFFFFFFFFFFFFFFFFFFFFFFFFFFFFFFFFFFFFFFFFFFFF
FFFFFFFFFFFFFFFFFFFFFFFFFFFFFFFFFFFFFFFFFFFFFFFFFFFFFFFFFFFFFFFFF
FFFFFFFFFFFFFFFFFFFFFFFFFFFFFFFFFFFFFFFFFFFFFFFFFFFFFFFFFFFFFFFFF
FFFFFFFFFFFFFFFFFFFFFFFFFFFFFFFFFFFFFFFFFFFFFFFFFFFFFFFFFFFFFFFFF
FFFFFFFFFFFFFFFFFFFFFFFFFFFFFFFFFFFFFFFFFFFFFFFFFFFFFFFFFFFFFFFFF
FFFFFFFFFFFFFFFFFFFFFFFFFFFFFFFFFFFFFFFFFFFFFFFFFFFFFFFFFFFFFFFFF
FFFFFFFFFFFFFFFFFFFFFFFFFFFFFFFFFFFFFFFFFFFFFFFFFFFFFFFFFFFFFFFFF
FFFFFFFFFFFFFFFFFFFFFFFFFFFFFFFFFFFFFFFFFFFFFFFFFFFFFFFFFFFFFFFFF
FFFFFFFFFFFFFFFFFFFFFFFFFFFFFFFFFFFFFFFFFFFFFFFFFFFFFFFFFFFFFFFFF
FFFFFFFFFFFFFFFFFFFFFFFFFFFFFFFFFFFFFFFFFFFFFFFFFFFFFFFFFFFFFFFFF
FFFFFFFFFFFFFFFFFFFFFFFFFFFFFFFFFFFFFFFFFFFFFFFFFFFFFFFFFFFFFFFFF
FFFFFFFFFFFFFFFFFFFFFFFFFFFFFFFFFFFFFFFFFFFFFFFFFFFFFFFFFFFFFFFFF
FFFFFFFFFFFFFFFFFFFFFFFFFFFFFFFFFFFFFFFFFFFFFFFFFFFFFFFFFFFFFFFFF
FFFFFFFFFFFFFFFFFFFFFFFFFFFFFFFFFFFFFFFFFFFFFFFFFFFFFFFFFFFFFFFFF
FFFFFFFFFFFFFFFFFFFFFFFFFFFFFFFFFFFFFFFFFFFFFFFFFFFFFFFFFFFFFFFFF
FFFFFFFFFFFFFFFFFFFFFFFFFFFFFFFFFFFFFFFFFFFFFFFFFFFFFFFFFFFFFFFFF
FFFFFFFFFFFFFFFFFFFFFFFFFFFFFFFFFFFFFFFFFFFFFFFFFFFFFFFFFFFFFFFFF
FFFFFFFFFFFFFFFFFFFFFFFFFFFFFFFFFFFFFFFFFFFFFFFFFFFFFFFFFFFFFFFFF
FFFFFFFFFFFFFFFFFFFFFFFFFFFFFFFFFFFFFFFFFFFFFFFFFFFFFFFFFFFFFFFFF
FFFFFFFFFFFFFFFFFFFFFFFFFFFFFFFFFFFFFFFFFFFFFFFFFFFFFFFFFFFFFFFFF
FFFFFFFFFFFFFFFFFFFFFFFFFFFFFFFFFFFFFFFFFFFFFFFFFFFFFFFFFFFFFFFFF
FFFFFFFFFFFFFFFFFFFFFFFFFFFFFFFFFFFFFFFFFFFFFFFFFFFFFFFFFFFFFFFFF
FFFFFFFFFFFFFFFFFFFFFFFFFFFFFFFFFFFFFFFFFFFFFFFFFFFFFFFFFFFFFFFFF
FFFFFFFFFFFFFFFFFFFFFFFFFFFFFFFFFFFFFFFFFFFFFFFFFFFFFFFFFFFFFFFFF
FFFFFFFFFFFFFFFFFFFFFFFFFFFFFFFFFFFFFFFFFFFFFFFFFFFFFFFFFFFFFFFFF
FFFFFFFFFFFFFFFFFFFFFFFFFFFFFFFFFFFFFFFFFFFFFFFFFFFFFFFFFFFFFFFFF
FFFFFFFFFFFFFFFFFFFFFFFFFFFFFFFFFFFFFFFFFFFFFFFFFFFFFFFFFFFFFFFFF
FFFFFFFFFFFFFFFFFFFFFFFFFFFFFFFFFFFFFFFFFFFFFFFFFFFFFFFFFFFFFFFFF
FFFFFFFFFFFFFFFFFFFFFFFFFFFFFFFFFFFFFFFFFFFFFFFFFFFFFFFFFFFFFFFFF
FFFFFFFFFFFFFFFFFFFFFFFFFFFFFFFFFFFFFFFFFFFFFFFFFFFFFFFFFFFFFFFFF
FFFFFFFFFFFFFFFFFFFFFFFFFFFFFFFFFFFFFFFFFFFFFFFFFFFFFFFFFFFFFFFFF
FFFFFFFFFFFFFFFFFFFFFFFFFFFFFFFFFFFFFFFFFFFFFFFFFFFFFFFFFFFFFFFFF
FFFFFFFFFFFFFFFFFFFFFFFFFFFFFFFFFFFFFFFFFFFFFFFFFFFFFFFFFFFFFFFFF
FFFFFFFFFFFFFFFFFFFFFFFFFFFFFFFFFFFFFFFFFFFFFFFFFFFFFFFFFFFFFFFFF
FFFFFFFFFFFFFFFFFFFFFFFFFFFFFFFFFFFFFFFFFFFFFFFFFFFFFFFFFFFFFFFFF
FFFFFFFFFFFFFFFFFFFFFFFFFFFFFFFFFFFFFFFFFFFFFFFFFFFFFFFFFFFFFFFFF
FFFFFFFFFFFFFFFFFFFFFFFFFFFFFFFFFFFFFFFFFFFFFFFFFFFFFFFFFFFFFFFFF
FFFFFFFFFFFFFFFFFFFFFFFFFFFFFFFFFFFFFFFFFFFFFFFFFFFFFFFFFFFFFFFFF
FFFFFFFFFFFFFFFFFFFFFFFFFFFFFFFFFFFFFFFFFFFFFFFFFFFFFFFFFFFFFFFFF
FFFFFFFFFFFFFFFFFFFFFFFFFFFFFFFFFFFFFFFFFFFFFFFFFFFFFFFFFFFFFFFFF
FFFFFFFFFFFFFFFFFFFFFFFFFFFFFFFFFFFFFFFFFFFFFFFFFFFFFFFFFFFFFFFFF
FFFFFFFFFFFFFFFFFFFFFFFFFFFFFFFFFFFFFFFFFFFFFFFFFFFFFFFFFFFFFFFFF
FFFFFFFFFFFFFFFFFFFFFFFFFFFFFFFFFFFFFFFFFFFFFFFFFFFFFFFFFFFFFFFFF
FFFFFFFFFFFFFFFFFFFFFFFFFFFFFFFFFFFFFFFFFFFFFFFFFFFFFFFFFFFFFFFFF
FFFFFFFFFFFFFFFFFFFFFFFFFFFFFFFFFFFFFFFFFFFFFFFFFFFFFFFFFFFFFFFFF
FFFFFFFFFFFFFFFFFFFFFFFFFFFFFFFFFFFFFFFFFFFFFFFFFFFFFFFFFFFFFFFFF
FFFFFFFFFFFFFFFFFFFFFFFFFFFFFFFFFFFFFFFFFFFFFFFFFFFFFFFFFFFFFFFFF
FFFFFFFFFFFFFFFFFFFFFFFFFFFFFFFFFFFFFFFFFFFFFFFFFFFFFFFFFFFFFFFFF
FFFFFFFFFFFFFFFFFFFFFFFFFFFFFFFFFFFFFFFFFFFFFFFFFFFFFFFFFFFFFFFFF
FFFFFFFFFFFFFFFFFFFFFFFFFFFFFFFFFFFFFFFFFFFFFFFFFFFFFFFFFFFFFFFFF
FFFFFFFFFFFFFFFFFFFFFFFFFFFFFFFFFFFFFFFFFFFFFFFFFFFFFFFFFFFFFFFFF
FFFFFFFFFFFFFFFFFFFFFFFFFFFFFFFFFFFFFFFFFFFFFFFFFFFFFFFFFFFFFFFFF
FFFFFFFFFFFFFFFFFFFFFFFFFFFFFFFFFFFFFFFFFFFFFFFFFFFFFFFFFFFFFFFFF
FFFFFFFFFFFFFFFFFFFFFFFFFFFFFFFFFFFFFFFFFFFFFFFFFFFFFFFFFFFFFFFFF
FFFFFFFFFFFFFFFFFFFFFFFFFFFFFFFFFFFFFFFFFFFFFFFFFFFFFFFFFFFFFFFFF
FFFFFFFFFFFFFFFFFFFFFFFFFFFFFFFFFFFFFFFFFFFFFFFFFFFFFFFFFFFFFFFFF
FFFFFFFFFFFFFFFFFFFFFFFFFFFFFFFFFFFFFFFFFFFFFFFFFFFFFFFFFFFFFFFFF
FFFFFFFFFFFFFFFFFFFFFFFFFFFFFFFFFFFFFFFFFFFFFFFFFFFFFFFFFFFFFFFFF
# Number of players
2
# Starting resources Player Gold Lumber Stone
0 55000 400 400
1 3000 5000 5000
2 0 0 0
# Number of assets
2
# Starting assets Type Owner X Y
GoldMine 0 25 25
Peasant 1 29 29
# AI Difficulty Scripts
./scripts/plague.lua
./scripts/plague.lua
./scripts/plague.lua
# Events Script
./scripts/events.lua
# Trigger Count
27
# Triggers
1 1 0 All = 0 EndGame 0 1
3 0 0 > 1200 0 EndGame 1 1
2 1 1 All 0 9 0 63 RemoveAsset
2 1 1 All 54 63 0 63 RemoveAsset
2 1 1 All 0 63 0 9 RemoveAsset
2 1 1 All 0 63 54 63 RemoveAsset
3 0 1 > 50 60 AddAsset Footman 2 10 0
3 0 1 > 650 45 AddAsset Archer 2 10 1
3 0 1 > 800 45 AddAsset Footman 2 11 1
3 0 1 > 950 30 AddAsset Ranger 2 11 0
3 0 1 > 50 60 AddAsset Footman 2 63 17
3 0 1 > 650 45 AddAsset Archer 2 62 17
3 0 1 > 800 45 AddAsset Footman 2 62 18
3 0 1 > 950 30 AddAsset Ranger 2 63 18
3 0 1 > 50 60 AddAsset Footman 2 63 59
3 0 1 > 650 45 AddAsset Archer 2 62 59
3 0 1 > 800 45 AddAsset Footman 2 62 58
3 0 1 > 950 30 AddAsset Ranger 2 63 58
3 0 1 > 50 60 AddAsset Footman 2 0 63
3 0 1 > 650 45 AddAsset Archer 2 0 62
3 0 1 > 800 45 AddAsset Footman 2 1 62
3 0 1 > 950 30 AddAsset Ranger 2 1 63
3 0 1 > 300 90 KillRandPlayerUnit
3 0 1 > 600 90 KillRandPlayerUnit
3 0 1 > 810 90 KillRandPlayerUnit
6 1 1 Fighter > 0 ResourceChange 200 Lumber
6 1 1 Fighter > 0 ResourceChange 200 Stone